WWWWWWWWWW
W    B   W
W  HHVV  W
W A  X CSW
W    WWWWW
Wb    W  E 
W  U  W  W
W  Y  W  W
W  R  T  W
WWWWWWWWWW