WWWWWWWWWW
W  B     W
W  HHHH  W
WR    R  W
W   SWWWWW
W    X    
WV   X   W
WV R W   W
WV R   C W
WWWWWWWWWW