WWWWWWWWWW
W    B   W
W  HHVV  W
W    X CSW
W    WWWWW
WU A  W  E 
W     W  W
W        W
W  Y    TW
WWWWWWWWWW