WWWWWWWWWW
W        W
W        W
W        W
W WW WWWWW
W   S W  W 
W   B W  E
W     W  W
W        W
WWWWWWWWWW