WWWWWWWWWW
W    B   W
W  HHVV  W
W    X CSW
W    WWWWW
W  U  W  E 
W     W  W
W        W
W R      W
WWWWWWWWWW