WWWWWWWWWW
W        W
W  HHVV SW
W A  X C W
W    WWWWW
W UR  W  E 
W     W  W
W  B     W
W  Y    TW
WWWWWWWWWW