WWWWWWWWWW
W R      W
W  HHVV  W
W A  X CSW
W  T WWWWW
Wb    W  E 
W   B W  W
W    W   W
W  Y     W
WWWWWWWWWW