WWWWWWWWWW
W        W
W bHHVV SW
W A CX C W
W   BWWWWW
W  R  W  E 
W   U W  W
W        W
W  Y    TW
WWWWWWWWWW