WWWWWWWWWW
W  A BWV W
W  WWWWV W
WYYW    SW
W     b  W
W    WWWWW 
W    X C E
W   WWWW W
WYY  T   W
WWWWWWWWWW