WWWWWWWWWW
W B     SW
W   HHH  W
W   V    W
W   C    W
W   b    W
W   Y A  W
W   T    W
W   X    W
WWWWWWWWWW