WWWWWWWWWW
W    B   W
W  HHVV  W
W    X CSW
W    WWWWW
Wb U  W  E 
W  A  W  W
W  Y  W  W
W  R  T  W
WWWWWWWWWW