WWWWWWWWWW
W R   C  W
W  HHVV  W
W B   X  W
W  Y WWWWW
W S    W    
W    W   W
W  A W   W
W  b    TW
WWWWWWWWWW