WWWWWWWWWW
W W   W  W
W R      E
W WWWXWWWW
W WWWXW  W
W  W  XB W 
W WWWWW SW
W W  WW  W
W U  U   W
WWWWWWWWWW