WWWWWWWWWW
W B      W
W   b    W
W   R    W
W   Y    W
W   A    W
W   C    W
W   X S  W
W   T    W
WWWWWWWWWW