WWWWWWWWWW
W        W
W bHHVV SW
W A  X C W
W    WWWWW
W  RB W  E 
W   U W  W
W        W
W  Y    TW
WWWWWWWWWW