WWWWWWWWWW
W R  bC  W
W  HHVV  W
W  A   X W
W  T WWWWW
W   S W    
W   B W  W
W    W   W
W  Y     W
WWWWWWWWWW