WWWWWWWWWW
W    B   W
W  HHVV  W
W A  X CSW
W  T WWWWW
Wb    W  E 
W     W  W
W  Y  W  W
W  R     W
WWWWWWWWWW