WWWWWWWWWW
W R   C  W
W  HHVV  W
W BA  X  W
W    WWWWW
Wb S   W    
W    W   W
W    W   W
W  Y    TW
WWWWWWWWWW