WWWWWWWWWW
W   B    W
W  RrR   W
W  HHH   W
W   b    W
W   Y A  W
W  C T   W
W   X    W
W S   V  W
WWWWWWWWWW