WWWWWWWWWW
W        W
W bHHVV SW
W A  X C W
W    WWWWW
W BR  W  E 
W  Y UW  W
W        W
W       TW
WWWWWWWWWW